1111111114
1021444441
1000000001
1000000201
1000090001
1200011111
1110011111
1110033331
1111111111
