1111111114
1001444441
10?00000+1
1000+00201
1000090001
1000011111
1110011111
1110033331
1111111111
