2111111114
1001333331
1000000001
1000000201
10?0090001
1000011111
1110011111
1110044441
1111111111
