3111111114
1001444441
1000000001
10000+0201
1000090?01
10!0011111
1110011111
1110033331
1111111111
