1111111114
1001444441
1000000001
1000000201
1000090001
1000011111
1110011111
1110033331
1111111111
