1111111114
1001444441
10?00000+1
10?0+00201
10?00900!1
1000011111
1110011111
1110033331
1111111111
