1111111114
1001444441
10?0000001
10?0000201
1090000001
1000011111
1110011111
1110033331
1111111111
